W W W W W W W W W W W W W W W W W W W W W W W W W
W W W 0 0 0 0 W W W 0 0 0 0 W W W W 0 0 0 0 0 W W
W W 0 0 0 0 0 W W 0 0 0 0 0 0 W W 0 0 0 0 0 0 0 W
W 0 0 0 0 0 0 W 0 0 0 0 0 0 0 0 0 0 0 W W W 0 0 W
E 0 0 0 0 0 0 W 0 0 0 W 0 0 0 0 W 0 0 W W W 0 0 W
W 0 0 0 0 0 0 W 0 0 0 W 0 0 0 0 W 0 0 W W W 0 0 W
W W W 0 0 0 0 W W W W 0 0 0 0 W W 0 0 W W W 0 0 W
W W W 0 0 0 0 W W W 0 0 0 0 W W W 0 0 W W W 0 0 W
W W W 0 0 0 0 W W 0 0 0 0 W W W W 0 0 W W W 0 0 W
W W W 0 0 0 0 W 0 0 0 0 W W W W W 0 0 W W W 0 0 W
W W W 0 0 0 0 W 0 0 0 0 0 0 0 0 W 0 0 W W W 0 0 W
W W W 0 0 0 0 0 0 0 0 0 0 0 0 0 W 0 0 0 0 0 0 0 S
W W W 0 0 0 0 W 0 0 0 0 0 0 0 0 W W 0 0 0 0 0 W W
W W W W W W W W W W W W W W W W W W W W W W W W W
